153,153,153,153,153,153,153,153,153,153,153,153,153,153,153,153,153,153,153,153,153,153,153,153,153,153,153,153,153,153,153,153,153,153,153,153,153,153,153,153,153,153,153,153,153,153,153,153,153,153,153,153,153,153,153,153,153,153,153,153
153,153,153,153,153,153,153,153,153,153,153,153,153,153,153,153,153,153,153,153,153,153,153,153,153,153,153,153,153,153,153,153,153,153,153,153,153,153,153,153,153,153,153,153,153,153,153,153,153,153,153,153,153,153,153,153,153,153,153,153
153,153,153,153,153,153,153,153,153,153,153,153,153,153,153,153,153,153,153,153,153,153,153,153,153,153,153,153,153,153,153,153,153,153,153,153,153,153,153,153,153,153,153,153,153,153,153,153,153,153,153,153,153,153,153,153,153,153,153,153
153,153,153,153,153,153,153,153,153,153,153,153,153,153,153,153,153,153,153,153,153,153,153,153,153,153,153,153,153,153,153,153,153,153,153,153,153,153,153,153,153,153,153,153,153,153,153,153,153,153,153,153,153,153,153,153,153,153,153,153
153,153,153,153,153,153,153,153,153,153,153,153,153,153,153,153,153,153,153,153,153,153,153,153,153,153,153,153,153,153,153,153,153,153,153,153,153,153,153,153,153,153,153,153,153,153,153,153,153,153,153,153,153,153,153,153,153,153,153,153
153,153,153,153,153,153,153,153,153,153,153,153,153,153,153,153,153,153,153,153,153,153,153,153,153,153,153,153,153,153,153,153,153,153,153,153,153,153,153,153,153,153,153,153,153,153,153,153,153,153,153,153,153,153,153,153,153,153,153,153
153,153,153,153,153,153,153,153,153,153,153,153,153,153,153,153,153,153,153,153,153,153,153,153,153,153,153,153,153,153,153,153,153,153,153,153,153,153,153,153,153,153,153,153,153,153,153,153,153,153,153,153,153,153,153,153,153,153,153,153
153,153,153,153,153,153,153,153,153,153,153,153,153,153,153,153,153,153,153,153,153,153,153,153,153,153,153,153,153,153,153,153,153,153,153,153,153,153,153,153,153,153,153,153,153,153,153,153,153,153,153,153,153,153,153,153,153,153,153,153
153,153,153,153,153,153,153,153,153,153,153,153,153,153,153,153,153,153,153,153,153,153,153,153,153,153,153,153,153,153,153,153,153,153,153,153,153,153,153,153,153,153,153,153,153,153,153,153,153,153,153,153,153,153,153,153,153,153,153,153
153,153,153,153,153,153,153,153,153,153,44,45,45,45,45,45,45,45,45,45,45,45,45,45,45,45,45,45,45,45,45,45,45,45,45,45,45,45,45,45,45,45,45,45,45,45,45,45,45,46,153,153,153,153,153,153,153,153,153,153
153,153,153,153,153,153,153,153,153,153,54,51,51,51,51,51,51,51,51,51,51,51,51,51,51,51,51,51,51,51,51,51,51,51,51,51,51,51,51,51,51,51,51,51,51,51,51,51,51,56,153,153,153,153,153,153,153,153,153,153
153,153,153,153,153,153,153,153,153,153,54,51,51,51,51,55,55,51,51,51,51,55,51,51,51,51,51,51,51,51,51,51,51,51,51,51,51,51,51,51,51,51,51,51,51,51,51,55,51,56,153,153,153,153,153,153,153,153,153,153
153,153,153,153,153,153,153,153,153,153,54,55,51,51,51,55,51,51,51,51,51,51,51,51,51,55,55,55,55,55,51,51,51,51,51,51,51,51,55,55,55,55,51,51,51,51,55,51,51,56,153,153,153,153,153,153,153,153,153,153
153,153,153,153,153,153,153,153,153,153,54,51,55,55,51,51,51,51,51,51,55,51,51,55,55,55,51,51,51,51,51,51,51,51,51,51,51,51,51,51,51,51,51,51,51,51,51,51,51,56,153,153,153,153,153,153,153,153,153,153
153,153,153,153,153,153,153,153,153,153,54,51,51,51,51,51,51,51,51,51,51,51,55,51,51,51,51,55,51,51,51,51,51,51,51,51,51,51,51,51,51,55,51,51,55,55,51,51,51,56,153,153,153,153,153,153,153,153,153,153
153,153,153,153,153,153,153,153,153,153,54,51,51,51,51,55,51,51,51,51,51,51,51,51,51,51,51,51,51,51,51,51,51,51,51,51,51,55,51,51,51,51,51,51,51,51,51,51,51,56,153,153,153,153,153,153,153,153,153,153
153,153,153,153,153,153,153,153,153,153,54,55,51,33,51,51,51,51,51,51,51,51,51,51,51,51,51,51,51,51,55,55,55,51,51,51,51,55,51,51,51,51,51,51,55,55,55,51,51,56,153,153,153,153,153,153,153,153,153,153
153,153,153,153,153,153,153,153,153,153,54,51,51,51,51,55,51,51,51,55,55,51,51,51,51,51,51,51,51,51,51,51,51,55,55,55,55,55,51,51,51,51,51,51,51,51,51,51,51,56,153,153,153,153,153,153,153,153,153,153
153,153,153,153,153,153,153,153,153,153,54,51,51,51,51,51,51,51,51,51,51,51,51,51,51,51,51,51,51,51,51,51,51,51,51,51,55,55,51,51,51,51,51,51,51,51,51,51,51,56,153,153,153,153,153,153,153,153,153,153
153,153,153,153,153,153,153,153,153,153,54,51,51,51,51,51,51,51,51,51,51,51,51,51,51,51,51,51,51,51,51,51,51,51,51,51,55,51,51,51,51,51,51,51,51,55,55,51,51,56,153,153,153,153,153,153,153,153,153,153
153,153,153,153,153,153,153,153,153,153,54,51,51,51,55,51,51,51,55,51,51,51,55,51,51,51,51,55,55,55,51,51,51,55,55,51,51,51,51,51,51,51,51,51,55,55,51,51,51,56,153,153,153,153,153,153,153,153,153,153
153,153,153,153,153,153,153,153,153,153,54,51,51,51,51,55,51,51,51,51,51,51,51,51,51,51,51,51,51,51,51,51,51,51,51,51,51,51,51,51,51,51,51,51,51,55,51,51,51,56,153,153,153,153,153,153,153,153,153,153
153,153,153,153,153,153,153,153,153,153,54,51,55,51,51,51,51,51,51,51,51,51,51,51,51,51,51,51,51,51,51,51,51,51,55,51,51,51,51,51,51,55,51,51,51,51,51,51,51,56,153,153,153,153,153,153,153,153,153,153
153,153,153,153,153,153,153,153,153,153,54,51,51,51,51,51,55,51,51,51,51,51,51,51,51,51,55,51,51,51,51,51,51,51,51,51,51,51,51,55,51,51,51,51,51,51,51,51,51,56,153,153,153,153,153,153,153,153,153,153
153,153,153,153,153,153,153,153,153,153,64,65,65,65,65,65,65,65,65,65,65,65,65,65,65,65,65,65,65,65,65,65,65,65,65,65,65,65,65,65,65,65,65,65,65,65,65,65,65,66,153,153,153,153,153,153,153,153,153,153
153,153,153,153,153,153,153,153,153,153,110,110,110,110,110,110,110,110,110,110,110,110,110,110,110,110,110,110,110,110,110,110,110,110,110,110,110,110,110,110,110,110,110,110,110,110,110,110,110,110,153,153,153,153,153,153,153,153,153,153
153,153,153,153,153,153,153,153,153,153,153,153,153,153,153,153,153,153,153,153,153,153,153,153,153,153,153,153,153,153,153,153,153,153,153,153,153,153,153,153,153,153,153,153,153,153,153,153,153,153,153,153,153,153,153,153,153,153,153,153
153,153,153,153,153,153,153,153,153,153,153,153,153,153,153,153,153,153,153,153,153,153,153,153,153,153,153,153,153,153,153,153,153,153,153,153,153,153,153,153,153,153,153,153,153,153,153,153,153,153,153,153,153,153,153,153,153,153,153,153
153,153,153,153,153,153,153,153,153,153,153,153,153,153,153,153,153,153,153,153,153,153,153,153,153,153,153,153,153,153,153,153,153,153,153,153,153,153,153,153,153,153,153,153,153,153,153,153,153,153,153,153,153,153,153,153,153,153,153,153
153,153,153,153,153,153,153,153,153,153,153,153,153,153,153,153,153,153,153,153,153,153,153,153,153,153,153,153,153,153,153,153,153,153,153,153,153,153,153,153,153,153,153,153,153,153,153,153,153,153,153,153,153,153,153,153,153,153,153,153
153,153,153,153,153,153,153,153,153,153,153,153,153,153,153,153,153,153,153,153,153,153,153,153,153,153,153,153,153,153,153,153,153,153,153,153,153,153,153,153,153,153,153,153,153,153,153,153,153,153,153,153,153,153,153,153,153,153,153,153
153,153,153,153,153,153,153,153,153,153,153,153,153,153,153,153,153,153,153,153,153,153,153,153,153,153,153,153,153,153,153,153,153,153,153,153,153,153,153,153,153,153,153,153,153,153,153,153,153,153,153,153,153,153,153,153,153,153,153,153
153,153,153,153,153,153,153,153,153,153,153,153,153,153,153,153,153,153,153,153,153,153,153,153,153,153,153,153,153,153,153,153,153,153,153,153,153,153,153,153,153,153,153,153,153,153,153,153,153,153,153,153,153,153,153,153,153,153,153,153
153,153,153,153,153,153,153,153,153,153,153,153,153,153,153,153,153,153,153,153,153,153,153,153,153,153,153,153,153,153,153,153,153,153,153,153,153,153,153,153,153,153,153,153,153,153,153,153,153,153,153,153,153,153,153,153,153,153,153,153
